20 15
+-+-+-+-+-+-+-+-+-+-+-+-+-+-+-+-+-+-+-+-+
|*                                      |
+ + + +-+-+-+ + + +-+-+-+ + + + + + + + +
| | | |     | | | |     | | | | | | | | |
+-+-+ +-+ +-+ +-+-+ +-+ +-+ +-+-+-+-+-+-+
|         |           | | | | | | |     |
+-+-+-+-+-+-+-+-+-+-+-+ + + + + + + +-+ +
|X  | |             |     |           | |
+-+ + +-+-+ +-+-+-+ +-+-+-+ +-+-+-+-+-+-+
| | | | | | | | | | | | |   | | | |     |
+ + + + + + + + + +-+ + + +-+ + + +-+ +-+
|     | | | |     |   | | | | |   | | | |
+-+-+ + + + + + + + + + + + + +-+ + + + +
| | |   | | | | |   |                   |
+ + + +-+ + + + + + + + + + + + + + + + +
|                       | | | | | | | | |
+ + + + + + + + + + + + + + +-+-+-+-+ +-+
| | | | | | | | | | | | | | |           |
+ + + + + + + + + + +-+ +-+-+ + + +-+-+ +
| | | | | | | | | |   |     | | |     | |
+-+-+-+-+-+-+-+-+-+-+-+-+ +-+-+-+-+-+-+-+
| | | | | | | | | |   | |               |
+ + + + + + + + + + +-+ +-+-+-+-+ +-+-+-+
| | | |   | |   | |   | |         | | | |
+ + + + +-+ +-+ + + + + +-+ + +-+ + + + +
| | |           | | |     | | |   |   | |
+ + +-+-+-+-+ +-+ +-+-+-+ +-+-+ +-+ +-+ +
| | |   | | | | | | | | |   | | | |   | |
+ + + + + + + + + + + + + + + + + + +-+ +
|     |                   |             |
+-+-+-+-+-+-+-+-+-+-+-+-+-+-+-+-+-+-+-+-+

